SIL	SIL
a	a
aa	aa
ai	ai
b	b
c	c
d	d
dx	dx
e	e
ee	ee
eu	eu
g	g
h	h
i	i
ii	ii
j	j
k	k
l	l
lx	lx
m	m
n	n
nd	nd
ng	ng
nj	nj
nx	nx
o	o
oo	oo
p	p
r	r
rx	rx
s	s
sx	sx
t	t
tx	tx
u	u
uu	uu
w	w
y	y
zh	zh
